00000000000000000000
00000000000000000000
00000000000000000000
00000000000000000000
00000000000000000000
99999999999999999999
00000000000000000000
10001110101011101000
10001000101010001000
10001100101011001000
10001000111010001000
11101110010011101110
00000000000000000000
00000000010000000000
00000000110000000000
00000000010000000000
00000000010000000000
00000000010000000000
00000000111000000000
00000000000000000000
00000000000000000000
00000000000000000000
00000000000000000000
00000000000000000000
